11111111111
1C100D001C1
11000000011
1P000C000E1
10000000001
11111111111