00000000000
1C0011100C1
00011C11000
00110D01100
01100000110
01P00C00E10
01100000010
001100C1100
01011011010
0C0011101C1
01000000010