00000000000
0C0011100C0
00011011000
00110001100
01100000110
01P00C00E10
01100000010
00110001100
00011011000
0C0011100C0
00000000000