1111111111111
1000000000001
1000011100011
100011C110001
10011D0011001
1011000001101
101P00C00E101
1011000000101
1001100C11001
1010110110101
1000011101011
1010000000101
1111111111111